NO ./assets/north.xpm
SO   ./assets/south.xpm
WE     ./assets/west.xpm
EA   ./assets/east.xpm
     F    80  ,  80  ,  80


²
C 147   ,147,  147

11111111111
10000000001
10000000001
10000100001
10000000001
1001000S001
10010001001
11111111111