NO ./assets/north.xpm
SO   ./assets/south.xpm
WE     ./assets/west.xpm
EA   ./assets/east.xpm

     F    80  ,  80  ,  80



C 147   ,147,  147

11111111111111
10000000000001111
10000111000000001
1000010100000W011
11000000000000001
10000000011100001
11110000000000111
   111111111111