 NO ./assets/north.xpm
SO   ./assets/south.xpm
WE     ./assets/west.xpm
EA   ./assets/east.xpm

     F    80  ,  80  ,  80



C 147   ,147,  147

 111111111
 100000001                                   11111
 100000001                                   10001
 1000000011111111111111111111111111111111111110001
 1000W000O00000000000000000000000000000000000C0M01
 1000000011111111111111111111111111111111111110001
 100000001                                   10001
 100000001                                   11111
 111111111